tealBack,roomBorder,wall,open,wall,wall,,,,,,
---,---,---,---,---,---,---,---,---,---,---,---
---,bat,---,---,---,---,---,---,---,---,---,---
---,---,---,bat,---,---,---,---,---,---,---,---
---,---,---,---,---,---,---,---,---,---,---,---
---,---,---,---,---,---,---,---,---,---,---,---
---,bat,---,---,---,---,---,---,---,---,---,---
---,---,---,---,---,---,---,---,key,---,---,---
